NO ./textures/heaven/north.png
SO ./textures/heaven/south.png
WE ./textures/heaven/west.png
EA ./textures/heaven/east.png

F 100,255,100
C 50,50,255

1111111111111111111111111
1000000000000000000000001
1001111111000111111100001
1001000001000100000100001
1001000001000100000100001
1001000001111100000100001
1001000000000000000100001
1000000000000000000000001
1111100000111110000111111
1000000000000000000000001
1000000000000000000000001
1000000000111110000000001
1111100000000000000111111
1000000000000000000000001
1000000000000000000000001
100000000000N000000000001
1111111111111111111111111