NO ./textures/hell/north.png
SO ./textures/hell/south.png
WE ./textures/hell/west.png
EA ./textures/hell/east.png

F 0,0,0
C 255,0,0

1111111111111111111111111
1000000000000000000000001
1011111111111111111111101
1010000000000000000000101
1010111111011111101110101
1010100001010000100010101
1010111101010111111010101
1010000101010000001010101
1011110101111111011010101
10000101000N0000010010101
1111010111111111011110101
1000010000000001000000101
1011111111011111111111101
1010000001010000000000001
1010111111010111111111101
1010000000000000000000101
1011111111111111111111101
1000000000000000000000001
1111111111111111111111111