NO ./textures/jerusalem/north.png
SO ./textures/jerusalem/south.png
WE ./textures/jerusalem/west.png
EA ./textures/jerusalem/east.png

F 100,100,0
C 75,75,75

1111111111111111111111111
1000000000000110000000001
1001111111000111111100001
1001000001000100000000001
1001011101110110100100001
1001010101010100100100001
1001010101010100100111111
1001000101010100100000001
1001110101010111100111111
1000000100000000000000001
1011111111111101111111101
1010000000000000000000101
1010111111111111111110101
1010001000000000010000101
1011101111011111011111101
1000000001000000010000001
1000111111001111111000001
10000000000W0000000000001
1111111111111111111111111